111111111111
10C10C000C01
100001111101
1P0011E00C01
111111111111