11E111C1111P111111
11111111111C1111C1
11111111C111111111
11111111111C111111
111111111E111111C1
111111C111111111C1
11111111P111111111
11111111P111111111
11111111P111111111
111111111111111111
111111111111111111
111111111111111111
111111111111111111
111111111111111111
111111111111111111