1111111111
100C000011
1P000V0E11
100C000011
1111111111