11111111111111111111111
1C000000000000100000001
1000000000000000000C001
1101110000111100C001001
1E000000001111000010101
1111111100011100P111101
10000000000001001000011
10C00000000001000111101
1101110000111100000C001
10000000000C00000000001
11111111111111111111111